tbodyaccxmean  -  Time of body acceleration along axis x (mean value) 
tbodyaccymean  -  Time of body acceleration along axis y (mean value) 
tbodyacczmean  -  Time of body acceleration along axis z (mean value) 
tbodyaccxstd  -  Time of body acceleration along axis x (Standard deviation) 
tbodyaccystd  -  Time of body acceleration along axis y (Standard deviation) 
tbodyacczstd  -  Time of body acceleration along axis z (Standard deviation) 
tgravityaccxmean  -  Time of gravity acceleration along axis x (mean value) 
tgravityaccymean  -  Time of gravity acceleration along axis y (mean value) 
tgravityacczmean  -  Time of gravity acceleration along axis z (mean value) 
tgravityaccxstd  -  Time of gravity acceleration along axis x (Standard deviation) 
tgravityaccystd  -  Time of gravity acceleration along axis y (Standard deviation) 
tgravityacczstd  -  Time of gravity acceleration along axis z (Standard deviation) 
tbodyaccjerkxmean  -  Time of body acceleration jerk along axis x (mean value) 
tbodyaccjerkymean  -  Time of body acceleration jerk along axis y (mean value) 
tbodyaccjerkzmean  -  Time of body acceleration jerk along axis z (mean value) 
tbodyaccjerkxstd  -  Time of body acceleration jerk along axis x (Standard deviation) 
tbodyaccjerkystd  -  Time of body acceleration jerk along axis y (Standard deviation) 
tbodyaccjerkzstd  -  Time of body acceleration jerk along axis z (Standard deviation) 
tbodygyroxmean  -  Time of gyroscope along axis x (mean value) 
tbodygyroymean  -  Time of gyroscope along axis y (mean value) 
tbodygyrozmean  -  Time of gyroscope along axis z (mean value) 
tbodygyroxstd  -  Time of gyroscope along axis x (Standard deviation) 
tbodygyroystd  -  Time of gyroscope along axis y (Standard deviation) 
tbodygyrozstd  -  Time of gyroscope along axis z (Standard deviation) 
tbodygyrojerkxmean  -  Time of gyroscope jerk along axis x (mean value) 
tbodygyrojerkymean  -  Time of gyroscope jerk along axis y (mean value) 
tbodygyrojerkzmean  -  Time of gyroscope jerk along axis z (mean value) 
tbodygyrojerkxstd  -  Time of gyroscope jerk along axis x (Standard deviation) 
tbodygyrojerkystd  -  Time of gyroscope jerk along axis y (Standard deviation) 
tbodygyrojerkzstd  -  Time of gyroscope jerk along axis z (Standard deviation) 
tbodyaccmagmean  -  Time of body acceleration magnitude (mean value) 
tbodyaccmagstd  -  Time of body acceleration magnitude (Standard deviation) 
tgravityaccmagmean  -  Time of gravity acceleration magnitude (mean value) 
tgravityaccmagstd  -  Time of gravity acceleration magnitude (Standard deviation) 
tbodyaccjerkmagmean  -  Time of body acceleration jerk magnitude (mean value) 
tbodyaccjerkmagstd  -  Time of body acceleration jerk magnitude (Standard deviation) 
tbodygyromagmean  -  Time of gyroscope magnitude (mean value) 
tbodygyromagstd  -  Time of gyroscope magnitude (Standard deviation) 
tbodygyrojerkmagmean  -  Time of gyroscope jerk magnitude (mean value) 
tbodygyrojerkmagstd  -  Time of gyroscope jerk magnitude (Standard deviation) 
fbodyaccxmean  -  Frequency of body acceleration along axis x (mean value) 
fbodyaccymean  -  Frequency of body acceleration along axis y (mean value) 
fbodyacczmean  -  Frequency of body acceleration along axis z (mean value) 
fbodyaccxstd  -  Frequency of body acceleration along axis x (Standard deviation) 
fbodyaccystd  -  Frequency of body acceleration along axis y (Standard deviation) 
fbodyacczstd  -  Frequency of body acceleration along axis z (Standard deviation) 
fbodyaccjerkxmean  -  Frequency of body acceleration jerk along axis x (mean value) 
fbodyaccjerkymean  -  Frequency of body acceleration jerk along axis y (mean value) 
fbodyaccjerkzmean  -  Frequency of body acceleration jerk along axis z (mean value) 
fbodyaccjerkxstd  -  Frequency of body acceleration jerk along axis x (Standard deviation) 
fbodyaccjerkystd  -  Frequency of body acceleration jerk along axis y (Standard deviation) 
fbodyaccjerkzstd  -  Frequency of body acceleration jerk along axis z (Standard deviation) 
fbodygyroxmean  -  Frequency of gyroscope along axis x (mean value) 
fbodygyroymean  -  Frequency of gyroscope along axis y (mean value) 
fbodygyrozmean  -  Frequency of gyroscope along axis z (mean value) 
fbodygyroxstd  -  Frequency of gyroscope along axis x (Standard deviation) 
fbodygyroystd  -  Frequency of gyroscope along axis y (Standard deviation) 
fbodygyrozstd  -  Frequency of gyroscope along axis z (Standard deviation) 
fbodyaccmagmean  -  Frequency of body acceleration magnitude (mean value) 
fbodyaccmagstd  -  Frequency of body acceleration magnitude (Standard deviation) 
fbodyaccjerkmagmean  -  Frequency of body acceleration jerk magnitude (mean value)
activity - Type of activity
subject - id of subject
